1000000000000001
1000000000000001
1000000000000001
1000000000000001
1000000000000001
10000000000000C1
1000E0CE00000001
1001111111110001
100000C000000011
100000C000000101
10P0000000010001
111111LL11111111